Lucky Cat: Jokers: Baseball Card, Bloodstone, Cartomancer, Certificate, Dusk, Glass Joker, Golden Ticket, Hack, Hanging Chad, Oops! All 6s, Red Card, Sock and Buskin, Steel Joker, Stone Joker
Seance: Jokers: Arrowhead, Bloodstone, Blueprint, Brainstorm, Crazy Joker, Credit Card, DNA, Driver's License, Drunkard, Erosion, Fibonacci, Four Fingers, Hit the Road, Hologram, Joker Stencil, Juggler, Merry Andy, Onyx Agate, Perkeo, Scholar, Shortcut, Smeared Joker, The Family, Troubadour, Vampire, Wee Joker
Oops! All 6s: Jokers: 8 Ball, Baseball Card, Bloodstone, Business Card, Canio, Cavendish, Glass Joker, Gros Michel, Hallucination, Hanging Chad, Lucky Cat, Lusty Joker, Reserved Parking, Sock and Buskin, Space Joker
Canio: Jokers: Business Card, Cavendish, Chicot, Erosion, Glass Joker, Hologram, Oops! All 6s, Pareidolia, Perkeo, Trading Card, Triboulet, Yorick
To Do List: Jokers: Blueprint, Brainstorm
Riff-Raff: Jokers: Abstract Joker, Cavendish, Gros Michel
Reserved Parking: Jokers: Baron, Business Card, Half Joker, Midas Mask, Mime, Oops! All 6s, Pareidolia, Ride the Bus, Shoot the Moon, Smiley Face
Red Card: Jokers: Astronomer, Bloodstone, Business Card, Campfire, Constellation, Driver's License, Flash Card, Fortune Teller, Hallucination, Hologram, Lucky Cat, Matador, Rocket, Satellite, Steel Joker, Throwback, Vampire
Gros Michel: Jokers: Cavendish, Oops! All 6s, Riff-Raff
Midas Mask: Jokers: Baron, Business Card, Driver's License, Golden Ticket, Mime, Pareidolia, Reserved Parking, Ride the Bus, Scary Face, Shoot the Moon, Smiley Face, Vampire
Rocket: Jokers: Baseball Card, Bootstraps, Bull, Flash Card, Red Card
Hack: Jokers: Ancient Joker, Bloodstone, Blueprint, Brainstorm, Cartomancer, Certificate, DNA, Dusk, Fibonacci, Glass Joker, Greedy Joker, Hiker, Lucky Cat, Odd Todd, Ride the Bus, Seltzer, Showman, The Idol, Trading Card, Vagabond, Walkie Talkie, Wee Joker
Marble Joker: Jokers: Bootstraps, Burglar, Burnt Joker, Driver's License, Flash Card, Four Fingers, Half Joker, Hologram, Ride the Bus, Space Joker, Stone Joker, Supernova, Vampire
Devious Joker: Jokers: Crazy Joker, Four Fingers, Runner, Seance, Shortcut, The Order
The Family: Jokers: Cloud 9, Flower Pot, Greedy Joker, Seance, The Duo, The Order, The Tribe, The Trio, Walkie Talkie
Odd Todd: Jokers: Cloud 9, DNA, Even Steven, Fibonacci, Hack, Ride the Bus, Runner, Scholar, Shortcut, Trading Card
Space Joker: Jokers: Ancient Joker, Blueprint, Brainstorm, Burglar, Burnt Joker, Certificate, Crazy Joker, Green Joker, Half Joker, Marble Joker, Oops! All 6s, Ramen, Spare Trousers, Supernova
Satellite: Jokers: Astronomer, Constellation, Red Card
Smiley Face: Jokers: Baron, Business Card, Midas Mask, Pareidolia, Reserved Parking, Ride the Bus, Scary Face, Shoot the Moon, Sock and Buskin, Splash, Steel Joker, Triboulet
Delayed Gratification: Jokers: Banner, Castle, Drunkard, Four Fingers, Green Joker, Jolly Joker, Merry Andy, Ramen, Shortcut, Smeared Joker
Hit the Road: Jokers: Blueprint, Brainstorm, Certificate, DNA, Drunkard, Merry Andy, Seance, Yorick
Madness: Jokers: Abstract Joker, Obelisk, Pareidolia
Crazy Joker: Jokers: Card Sharp, Droll Joker, Four Fingers, Jolly Joker, Mad Joker, Runner, Seance, Shortcut, Space Joker, Supernova, Superposition, Seance, The Order, Zany Joker
Chaos the Clown: Jokers: Astronomer, Campfire, Constellation, Flash Card
Stone Joker: Jokers: Blueprint, Cartomancer, DNA, Glass Joker, Golden Ticket, Half Joker, Lucky Cat, Marble Joker, Steel Joker
Cavendish: Jokers: Ancient Joker, Blueprint, Brainstorm, Canio, Flash Card, Fortune Teller, Gros Michel, Oops! All 6s, Riff-Raff
Cartomancer: Jokers: Astronomer, Blueprint, Brainstorm, Burglar, Campfire, Cloud 9, Fortune Teller, Gift Card, Glass Joker, Golden Ticket, Greedy Joker, Green Joker, Hack, Luchador, Lucky Cat, Obelisk, Perkeo, Ride the Bus, Runner, Spare Trousers, Square Joker, Steel Joker, Stone Joker, Supernova, Wee Joker
Flower Pot: Jokers: Seeing Double, Smeared Joker, Splash, The Family, The Order, Walkie Talkie
Wee Joker: Jokers: Ancient Joker, Bloodstone, Burnt Joker, Cartomancer, Certificate, DNA, Drunkard, Even Steven, Fibonacci, Glass Joker, Hack, Half Joker, Hanging Chad, Hologram, Ice Cream, Joker, Merry Andy, Photograph, Seance, Square Joker, Trading Card
Flash Card: Jokers: Campfire, Cavendish, Certificate, Chaos the Clown, Cloud 9, Constellation, Golden Joker, Marble Joker, Matador, Red Card, Rocket
8 Ball: Jokers: Blueprint, Brainstorm, DNA, Fortune Teller, Oops! All 6s, Perkeo
Showman: Jokers: Gift Card, Hack, Invisible Joker, Mr. Bones
Baron: Jokers: Certificate, DNA, Half Joker, Juggler, Midas Mask, Mime, Raised Fist, Reserved Parking, Shoot the Moon, Smiley Face, Troubadour
Throwback: Jokers: Ice Cream, Red Card, Turtle Bean
Golden Joker: Jokers: Bull, Credit Card, Flash Card, Joker, Ramen, To the Moon
Onyx Agate: Jokers: Arrowhead, Blackboard, Bloodstone, Certificate, Droll Joker, Glass Joker, Gluttonous Joker, Photograph, Rough Gem, Seance, Smeared Joker, Steel Joker, The Idol, Triboulet
Jolly Joker: Jokers: Banner, Burglar, Crazy Joker, Delayed Gratification, Droll Joker, Green Joker, Half Joker, Mad Joker, Mystic Summit, Spare Trousers, Splash, Square Joker, Stuntman, The Duo, Walkie Talkie, Zany Joker
Brainstorm: Jokers: 8 Ball, Ancient Joker, Baseball Card, Blueprint, Burglar, Burnt Joker, Cartomancer, Cavendish, Ceremonial Dagger, Certificate, DNA, Egg, Faceless Joker, Hack, Hit the Road, Loyalty Card, Luchador, Mime, Mr. Bones, Perkeo, Seance, Space Joker, Stuntman, To Do List
Astronomer: Jokers: Campfire, Cartomancer, Chaos the Clown, Constellation, Ramen, Red Card, Satellite
Mime: Jokers: Baron, Blueprint, Brainstorm, Certificate, Half Joker, Juggler, Merry Andy, Midas Mask, Raised Fist, Reserved Parking, Shoot the Moon, Steel Joker, Stuntman, Troubadour
Card Sharp: Jokers: Burglar, Crazy Joker, Drunkard, Green Joker, Half Joker, Juggler, Spare Trousers, Supernova
Fortune Teller: Jokers: 8 Ball, Cartomancer, Cavendish, Certificate, Cloud 9, Hallucination, Perkeo, Red Card, Superposition, Vagabond, Vampire
Bull: Jokers: Bootstraps, Certificate, Cloud 9, Golden Joker, Matador, Rocket
Stuntman: Jokers: Blackboard, Blueprint, Brainstorm, Green Joker, Half Joker, Jolly Joker, Juggler, Mime, Raised Fist, Troubadour, Turtle Bean
Runner: Jokers: Cartomancer, Crazy Joker, Four Fingers, Odd Todd, Shortcut, Spare Trousers
Spare Trousers: Jokers: Burglar, Card Sharp, Cartomancer, Jolly Joker, Mad Joker, Obelisk, Runner, Space Joker, Square Joker, Supernova, Walkie Talkie
Loyalty Card: Jokers: Acrobat, Blueprint, Brainstorm, Burglar
Hanging Chad: Jokers: Bloodstone, Lucky Cat, Oops! All 6s, Photograph, Scary Face, Scholar, Walkie Talkie, Wee Joker
Smeared Joker: Jokers: Ancient Joker, Arrowhead, Bloodstone, Burnt Joker, Castle, Delayed Gratification, Droll Joker, Flower Pot, Gluttonous Joker, Greedy Joker, Lusty Joker, Onyx Agate, Rough Gem, Seance, Seeing Double, The Tribe, Troubadour, Walkie Talkie, Wrathful Joker
Sixth Sense: Jokers: Baseball Card, Credit Card, DNA, Perkeo
Mad Joker: Jokers: Crazy Joker, Droll Joker, Jolly Joker, Spare Trousers, Square Joker, Walkie Talkie, Zany Joker
Bloodstone: Jokers: Arrowhead, Baseball Card, Business Card, Droll Joker, Greedy Joker, Hack, Hallucination, Hanging Chad, Lucky Cat, Lusty Joker, Onyx Agate, Oops! All 6s, Red Card, Rough Gem, Seance, Smeared Joker, Sock and Buskin, The Idol, Triboulet, Wee Joker
Trading Card: Jokers: Canio, Castle, Drunkard, Erosion, Glass Joker, Hack, Merry Andy, Odd Todd, Ride the Bus, The Idol, Wee Joker
Pareidolia: Jokers: Business Card, Canio, Ceremonial Dagger, Chicot, Faceless Joker, Glass Joker, Golden Ticket, Luchador, Madness, Midas Mask, Mr. Bones, Photograph, Popcorn, Reserved Parking, Ride the Bus, Rough Gem, Scary Face, Smiley Face, Sock and Buskin, Splash, Vampire
The Tribe: Jokers: Ancient Joker, Droll Joker, Four Fingers, Gluttonous Joker, Greedy Joker, Smeared Joker, The Duo, The Family, The Order, The Trio, Troubadour
Blue Joker: Jokers: DNA, Green Joker, Half Joker, Ramen
Chicot: Jokers: Canio, Luchador, Pareidolia, Perkeo, Triboulet
Burnt Joker: Jokers: Ancient Joker, Blueprint, Brainstorm, Castle, Certificate, Drunkard, Four Fingers, Half Joker, Marble Joker, Shortcut, Smeared Joker, Space Joker, Steel Joker, Supernova, Wee Joker, Yorick
Blueprint: Jokers: 8 Ball, Acrobat, Ancient Joker, Baseball Card, Blueprint, Brainstorm, Burglar, Burnt Joker, Business Card, Cartomancer, Cavendish, Ceremonial Dagger, Certificate, DNA, Egg, Faceless Joker, Hack, Hit the Road, Loyalty Card, Luchador, Mime, Mr. Bones, Perkeo, Seance, Space Joker, Stone Joker, Stuntman, To Do List
Dusk: Jokers: Ancient Joker, Hack, Lucky Cat, Photograph, The Idol, Walkie Talkie
The Idol: Jokers: Bloodstone, DNA, Dusk, Gluttonous Joker, Greedy Joker, Hack, Lusty Joker, Onyx Agate, Photograph, Sock and Buskin, Splash, Trading Card, Vagabond
Joker: Jokers: Credit Card, Faceless Joker, Golden Joker, Steel Joker, Wee Joker
Greedy Joker: Jokers: Ancient Joker, Bloodstone, Cartomancer, Castle, Droll Joker, Gluttonous Joker, Hack, Lusty Joker, Rough Gem, Smeared Joker, Sock and Buskin, Splash, Steel Joker, Superposition, The Family, The Idol, The Tribe, Wrathful Joker
Steel Joker: Jokers: Burnt Joker, Cartomancer, DNA, Even Steven, Fibonacci, Glass Joker, Gluttonous Joker, Golden Ticket, Greedy Joker, Half Joker, Joker, Lucky Cat, Lusty Joker, Mime, Onyx Agate, Red Card, Scholar, Smiley Face, Stone Joker, Walkie Talkie, Wrathful Joker
Matador: Jokers: Bootstraps, Bull, Burglar, Flash Card, Green Joker, Red Card, To the Moon
To the Moon: Jokers: Baseball Card, Bootstraps, Golden Joker, Matador
Seeing Double: Jokers: Flower Pot, Smeared Joker, Splash, Walkie Talkie
Shortcut: Jokers: Baseball Card, Blackboard, Burnt Joker, Crazy Joker, Delayed Gratification, Four Fingers, Odd Todd, Runner, Seance, Superposition, Seance, The Order, Walkie Talkie
Triboulet: Jokers: Bloodstone, Business Card, Canio, Chicot, Onyx Agate, Perkeo, Photograph, Smiley Face, Sock and Buskin, Yorick
Clever Joker: Jokers: Jolly Joker, Mad Joker, Spare Trousers, Square Joker, Walkie Talkie
Fibonacci: Jokers: Certificate, Hack, Odd Todd, Seance, Scholar, Steel Joker, Wee Joker
Troubadour: Jokers: Baron, Half Joker, Juggler, Mime, Seance, Smeared Joker, Stuntman, The Tribe, Turtle Bean
Sly Joker: Jokers: Half Joker, Jolly Joker, Mad Joker, The Duo, Walkie Talkie
Swashbuckler: Jokers: Egg, Gift Card
Constellation: Jokers: Ancient Joker, Astronomer, Certificate, Chaos the Clown, Flash Card, Obelisk, Perkeo, Red Card, Satellite
Egg: Jokers: Blueprint, Brainstorm, Ceremonial Dagger, Swashbuckler
Ramen: Jokers: Abstract Joker, Astronomer, Banner, Blue Joker, Burglar, Castle, Delayed Gratification, Golden Joker, Green Joker, Half Joker, Popcorn, Scholar, Space Joker, Turtle Bean, Walkie Talkie
Blackboard: Jokers: Baseball Card, Four Fingers, Onyx Agate, Shortcut, Stuntman
Gluttonous Joker: Jokers: Ancient Joker, Castle, Droll Joker, Greedy Joker, Lusty Joker, Onyx Agate, Smeared Joker, Steel Joker, The Idol, The Tribe, Wrathful Joker
DNA: Jokers: 8 Ball, Ancient Joker, Baron, Blue Joker, Blueprint, Brainstorm, Certificate, Cloud 9, Driver's License, Glass Joker, Hack, Hit the Road, Hologram, Odd Todd, Seance, Scholar, Shoot the Moon, Sixth Sense, Steel Joker, Stone Joker, The Idol, Vampire, Wee Joker
Golden Ticket: Jokers: Cartomancer, Lucky Cat, Midas Mask, Pareidolia, Sock and Buskin, Steel Joker, Stone Joker
Diet Cola: Jokers: Luchador
Vagabond: Jokers: Burglar, Credit Card, Fortune Teller, Green Joker, Hack, Perkeo, The Idol
Vampire: Jokers: Certificate, DNA, Fortune Teller, Green Joker, Marble Joker, Midas Mask, Pareidolia, Red Card, Seance
Acrobat: Jokers: Ancient Joker, Blueprint, Green Joker, Loyalty Card
Credit Card: Jokers: Credit Card, Golden Joker, Joker, Seance, Sixth Sense, Vagabond
Business Card: Jokers: Bloodstone, Blueprint, Canio, Midas Mask, Oops! All 6s, Pareidolia, Red Card, Reserved Parking, Ride the Bus, Scary Face, Seltzer, Smiley Face, Sock and Buskin, Splash, Triboulet
The Order: Jokers: Crazy Joker, Flower Pot, Shortcut, The Duo, The Family, The Tribe, The Trio, Walkie Talkie
Popcorn: Jokers: Ice Cream, Pareidolia, Ramen, Turtle Bean
Cloud 9: Jokers: Baseball Card, Bootstraps, Bull, Cartomancer, DNA, Flash Card, Fortune Teller, Hologram, Odd Todd, Perkeo, The Family, The Trio
Green Joker: Jokers: Acrobat, Banner, Blue Joker, Burglar, Card Sharp, Cartomancer, Delayed Gratification, Half Joker, Hologram, Jolly Joker, Matador, Ramen, Space Joker, Splash, Square Joker, Stuntman, Supernova, Vagabond, Vampire
Crafty Joker: Jokers: Droll Joker, Gluttonous Joker, Greedy Joker, Lusty Joker, Smeared Joker, The Tribe
Mr. Bones: Jokers: Blueprint, Brainstorm, Pareidolia, Showman
Ceremonial Dagger: Jokers: Abstract Joker, Blueprint, Brainstorm, Egg, Gift Card, Pareidolia
Sock and Buskin: Jokers: Ancient Joker, Bloodstone, Business Card, Golden Ticket, Greedy Joker, Lucky Cat, Oops! All 6s, Pareidolia, Photograph, Scary Face, Smiley Face, The Idol, Triboulet, Walkie Talkie
Four Fingers: Jokers: Blackboard, Burnt Joker, Crazy Joker, Delayed Gratification, Droll Joker, Four Fingers, Marble Joker, Runner, Seance, Shortcut, Square Joker, Superposition, Seance, The Tribe
Merry Andy: Jokers: Banner, Castle, Delayed Gratification, Faceless Joker, Hit the Road, Juggler, Mime, Seance, Trading Card, Wee Joker, Yorick
Invisible Joker: Jokers: Luchador, Showman
Mystic Summit: Jokers: Burglar, Jolly Joker, Yorick
Ancient Joker: Jokers: Acrobat, Blueprint, Brainstorm, Burnt Joker, Castle, Cavendish, Constellation, DNA, Dusk, Even Steven, Gluttonous Joker, Greedy Joker, Hack, Hologram, Lusty Joker, Photograph, Scholar, Seltzer, Smeared Joker, Sock and Buskin, Space Joker, The Tribe, Walkie Talkie, Wee Joker
Burglar: Jokers: Blueprint, Brainstorm, Card Sharp, Cartomancer, Castle, Green Joker, Jolly Joker, Loyalty Card, Marble Joker, Matador, Mystic Summit, Ramen, Ride the Bus, Space Joker, Spare Trousers, Splash, Square Joker, Supernova, Vagabond
Zany Joker: Jokers: Crazy Joker, Droll Joker, Jolly Joker, Mad Joker, The Trio, Walkie Talkie
Campfire: Jokers: Astronomer, Cartomancer, Chaos the Clown, Flash Card, Luchador, Perkeo, Red Card
Scholar: Jokers: Ancient Joker, Certificate, DNA, Fibonacci, Hanging Chad, Odd Todd, Photograph, Ramen, Seance, Splash, Steel Joker, Superposition, Walkie Talkie
Castle: Jokers: Ancient Joker, Banner, Burglar, Burnt Joker, Delayed Gratification, Drunkard, Gluttonous Joker, Greedy Joker, Merry Andy, Ramen, Smeared Joker, Trading Card, Yorick
Wily Joker: Jokers: Half Joker, The Trio, Walkie Talkie, Zany Joker
Even Steven: Jokers: Ancient Joker, Odd Todd, Ride the Bus, Steel Joker, Walkie Talkie, Wee Joker
Gift Card: Jokers: Cartomancer, Ceremonial Dagger, Luchador, Perkeo, Showman, Swashbuckler
Ice Cream: Jokers: Popcorn, Throwback, Turtle Bean, Wee Joker
Drunkard: Jokers: Banner, Burnt Joker, Card Sharp, Castle, Delayed Gratification, Faceless Joker, Hit the Road, Mail-In Rebate, Seance, Superposition, Seance, Trading Card, Wee Joker, Yorick
Joker Stencil: Jokers: Certificate, Seance
Scary Face: Jokers: Business Card, Hanging Chad, Midas Mask, Pareidolia, Smiley Face, Sock and Buskin, Splash
Shoot the Moon: Jokers: Baron, Certificate, DNA, Half Joker, Juggler, Midas Mask, Mime, Reserved Parking, Ride the Bus, Smiley Face
Baseball Card: Jokers: Blackboard, Bloodstone, Blueprint, Brainstorm, Cloud 9, Glass Joker, Hologram, Luchador, Lucky Cat, Oops! All 6s, Rocket, Shortcut, Sixth Sense, Seance, To the Moon
Square Joker: Jokers: Burglar, Cartomancer, Four Fingers, Green Joker, Half Joker, Jolly Joker, Mad Joker, Photograph, Spare Trousers, Splash, Wee Joker
Yorick: Jokers: Burnt Joker, Canio, Castle, Drunkard, Faceless Joker, Hit the Road, Juggler, Mail-In Rebate, Merry Andy, Mystic Summit, Perkeo, Triboulet
Perkeo: Jokers: 8 Ball, Blueprint, Brainstorm, Campfire, Canio, Cartomancer, Chicot, Cloud 9, Constellation, Fortune Teller, Gift Card, Hallucination, Seance, Sixth Sense, Superposition, Seance, Triboulet, Vagabond, Yorick
Abstract Joker: Jokers: Ceremonial Dagger, Madness, Ramen, Riff-Raff
The Trio: Jokers: Cloud 9, Half Joker, The Duo, The Family, The Order, The Tribe, Walkie Talkie, Zany Joker
Bootstraps: Jokers: Bull, Cloud 9, Marble Joker, Matador, Rocket, To the Moon
Wrathful Joker: Jokers: Droll Joker, Gluttonous Joker, Greedy Joker, Lusty Joker, Smeared Joker, Steel Joker
Hologram: Jokers: Ancient Joker, Baseball Card, Canio, Certificate, Cloud 9, DNA, Green Joker, Marble Joker, Red Card, Seance, Wee Joker
Arrowhead: Jokers: Bloodstone, Certificate, Droll Joker, Onyx Agate, Rough Gem, Seance, Smeared Joker
Juggler: Jokers: Baron, Card Sharp, Half Joker, Merry Andy, Mime, Seance, Shoot the Moon, Stuntman, Troubadour, Turtle Bean, Yorick
Driver's License: Jokers: No synergies
Glass Joker: Jokers: Baseball Card, Canio, Cartomancer, Certificate, DNA, Erosion, Hack, Lucky Cat, Onyx Agate, Oops! All 6s, Pareidolia, Splash, Steel Joker, Stone Joker, Trading Card, Wee Joker
Ride the Bus: Jokers: Burglar, Business Card, Cartomancer, Even Steven, Hack, Marble Joker, Midas Mask, Odd Todd, Pareidolia, Reserved Parking, Shoot the Moon, Smiley Face, Splash, Trading Card
Luchador: Jokers: Baseball Card, Blueprint, Brainstorm, Campfire, Cartomancer, Chicot, Diet Cola, Gift Card, Invisible Joker, Pareidolia
Raised Fist: Jokers: Baron, Certificate, Half Joker, Mime, Stuntman
Walkie Talkie: Jokers: Ancient Joker, Dusk, Even Steven, Flower Pot, Hack, Hanging Chad, Jolly Joker, Mad Joker, Ramen, Scholar, Seeing Double, Seltzer, Shortcut, Smeared Joker, Sock and Buskin, Spare Trousers, Steel Joker, Superposition, The Duo, The Family, The Order, The Trio, Zany Joker
Misprint: Jokers: No synergies
Banner: Jokers: Castle, Delayed Gratification, Drunkard, Green Joker, Jolly Joker, Merry Andy, Ramen
Hallucination: Jokers: Bloodstone, Fortune Teller, Oops! All 6s, Perkeo, Red Card
Turtle Bean: Jokers: Half Joker, Ice Cream, Juggler, Popcorn, Ramen, Seltzer, Stuntman, Throwback, Troubadour
Erosion: Jokers: Canio, Glass Joker, Seance, Trading Card
Seltzer: Jokers: Ancient Joker, Business Card, Hack, Photograph, Turtle Bean, Walkie Talkie
Superposition: Jokers: Crazy Joker, Drunkard, Fortune Teller, Four Fingers, Greedy Joker, Perkeo, Scholar, Shortcut, Walkie Talkie
Half Joker: Jokers: Baron, Blue Joker, Burnt Joker, Card Sharp, Certificate, Green Joker, Jolly Joker, Juggler, Marble Joker, Mime, Raised Fist, Ramen, Reserved Parking, Shoot the Moon, Space Joker, Splash, Square Joker, Steel Joker, Stone Joker, Stuntman, Supernova, The Duo, The Trio, Troubadour, Turtle Bean, Wee Joker
Lusty Joker: Jokers: Ancient Joker, Bloodstone, Droll Joker, Gluttonous Joker, Greedy Joker, Oops! All 6s, Smeared Joker, Steel Joker, The Idol, Wrathful Joker
Splash: Jokers: Burglar, Business Card, Flower Pot, Glass Joker, Greedy Joker, Green Joker, Half Joker, Hiker, Jolly Joker, Pareidolia, Ride the Bus, Scary Face, Scholar, Seeing Double, Smiley Face, Square Joker, The Idol
Mail-In Rebate: Jokers: Drunkard, Yorick
Photograph: Jokers: Ancient Joker, Certificate, Dusk, Hanging Chad, Onyx Agate, Pareidolia, Scholar, Seltzer, Sock and Buskin, Square Joker, The Idol, Triboulet, Wee Joker
Supernova: Jokers: Burglar, Burnt Joker, Card Sharp, Cartomancer, Crazy Joker, Green Joker, Half Joker, Marble Joker, Space Joker, Spare Trousers
The Duo: Jokers: Half Joker, Jolly Joker, The Family, The Order, The Tribe, The Trio, Walkie Talkie
Droll Joker: Jokers: Arrowhead, Bloodstone, Crazy Joker, Four Fingers, Gluttonous Joker, Greedy Joker, Jolly Joker, Lusty Joker, Mad Joker, Onyx Agate, Rough Gem, Smeared Joker, The Tribe, Wrathful Joker, Zany Joker
Certificate: Jokers: Arrowhead, Baron, Blueprint, Brainstorm, Bull, Burnt Joker, Constellation, DNA, Fibonacci, Flash Card, Fortune Teller, Glass Joker, Hack, Half Joker, Hit the Road, Hologram, Joker Stencil, Lucky Cat, Mime, Onyx Agate, Photograph, Raised Fist, Scholar, Shoot the Moon, Space Joker, Vampire, Wee Joker
Faceless Joker: Jokers: Blueprint, Brainstorm, Drunkard, Joker, Merry Andy, Pareidolia, Yorick
Obelisk: Jokers: Cartomancer, Constellation, Madness, Spare Trousers
Rough Gem: Jokers: Arrowhead, Bloodstone, Droll Joker, Greedy Joker, Onyx Agate, Pareidolia, Smeared Joker
Hiker: Jokers: Hack, Splash
